WWWWWWWWWWWWWWWWWWWWWWWWWWWWWWWWWWWWWWWWWWWWWWWWWWWWWWWWWWWWWWWWWWWWWWWW
WWWWWWWWWWWWWWWWWWWWWWWWWWWWWWWWWWWWWWWWWWWWWWWWWWWWWWWWWWWWWWWWWWWWWWWW
WWoooooo          WWWWWW                      WW                      WW
WWooooooWW  WW  WW  WW  WWWWWWWWWWWW  WWWWWWWW      WW  WW  WW  WWWWWWWW
WWooooooWW  WWWW                  WW  WW      WWWWWWWW  WW  WW      WWWW
WWWW          WW  WW  WWWWWWWWWW  WW  WWWWWW  WW      WW        WWWWWWWW
WW    WWWWWW  WWWWWWWWWW          WW        WWWW  WW  WW  WWWW      WWWW
WWWW  WW                WWWWWWWW  WW  WWWW  WW    WW  WW        WWWWWWWW
WW    WW  WWWWWWWWWWWW                    WWWW  WW    WW  WWWWWW    WWWW
WWWW  WW                WWWWWW  WWWWWWWW  WW    WWWW  WW  WW    WW    WW
WW    WWWWWWWWWWWWWWWWWW    WW  WW        WW  WW      WW  WW  WWWWWWWWWW
WWWW                  WWWWWWWW  WW  WWWW  WW  WWWWWW  WW  WW          WW
WWWW  WW  WWWWWWWWWWWW          WW    WW  WWWW        WW  WW  WWWWWWWWWW
WWWWWW    WW          WW  WWWW    WW  WW      WWWW  WWWW              WW
WWWWWWWW    WWWWWWWWWWWW  WW  WW  WW  WWWWWW    WW  WW  WWWWWWWW  WWWWWW
WW      WWWW          WW  WW  WW      WW    WWWWWW  WW        WW      WW
WW  WW  WW  WWWWWWWWWWWW  WW  WWWWWW  WW            WW  WWWWWW    WWWWWW
WW  WW  WW                WW          WWWWWWWWWWWW      WW    WW      WW
WW  WW  WW  WWWWWWWWWWWW  WW  WWWWWW                WW  WWWW  WW  WWWWWW
WW  WW  WW  WW        WW  WW  WW    WWWWWWWWWWWWWWWW          WW      WW
WW  WW  WW  WWWWWWWW  WW      WW  WW              WWWWWWWWWW  WW  WWWWWW
WW  WW  WW  WW        WWWW  WWWW  WW  WWWWWWWW  WW                  WWWW
WW  WW  WW  WW  WWWWWW      WW    WW        WW  WWWWW WWWWWWWW  WWWW  WW
WW  WW  WW  WW  WW  WW  WWWW  WWWWWWWW  WW  WW                WWWWWW  WW
WW  WW  WW  WW  WW  WW  WWWW            WW  WW  WWWWWWWWWWWWWW      WWWW
WW  WWWW              WW      WWWWWWWW  WW  WW                WWWWWWWWWW
WW      WWWWWWWW  WW  WW  WW            WW  WWWWWWWWWWWWWWWWWW        WW
WW  WW        WW  WW  WW  WW  WW  WW  WW                    WW  WWWW  WW
WW  WWWWWWWWWWWW      WW  WW  WW  WW  WW  WWWWWWWWWWWWWWWW  WW  WWWW  WW
WW              WWWW  WW  WW  WW  WWWW  WW              WW  WW      WWWW
WWWWWWWWWW  WW        WW  WW  WWWW  WW  WW  WWWWWWWWWW  WW    WWWWWW  WW
WW          WWWWWWWW  WW  WW        WW  WW  WW          WW  WW      WWWW
WW  WWWWWW  WW              WW  WW      WW  WW  WW  WW  WWWW  WW  WWWWWW
WW          WW  WWWWWW  WW  WW  WW  WW  WW  WW  WW  WW        WW  WW  WW
WW  WWWWWWWWWW      WW  WW  WW  WW  WW      WW  WW  WW  WWWWWW  ppppppWW
WW            WWWW  WW      WW    WW  WWWW  WWWWWWWWWW          ppppppWW
WW  WWWWWWWW    WW  WWWWWWWWWWWWWW  WW    WW          WWWW  WWWWppppppWW
WWWWWWWWWWWWWWWWWWWWWWWWWWWWWWWWWWWWWWWWWWWWWWWWWWWWWWWWWWWWWWWWWWWWWWWW
WWWWWWWWWWWWWWWWWWWWWWWWWWWWWWWWWWWWWWWWWWWWWWWWWWWWWWWWWWWWWWWWWWWWWWWW
